//MAP CONVERTED BY dmm2tgm.py THIS HEADER COMMENT PREVENTS RECONVERSION, DO NOT REMOVE
"an" = (
/obj/structure/bed/sofa/left/beige{
	dir = 8
	},
/turf/simulated/floor/wood/yew,
/area/space)
"bB" = (
/obj/structure/flora/pottedplant/shoot,
/turf/exterior/dry,
/area/space)
"bD" = (
/obj/structure/gravemarker,
/turf/exterior/dry,
/area/space)
"bS" = (
/obj/machinery/computer/dummy{
	dir = 8
	},
/turf/simulated/floor/wood/yew,
/area/space)
"cq" = (
/obj/structure/flora/pottedplant/smalltree,
/turf/exterior/dry,
/area/space)
"cM" = (
/obj/structure/flora/pottedplant/tall,
/turf/exterior/sand,
/area/space)
"ec" = (
/obj/machinery/optable,
/turf/simulated/floor/wood/yew,
/area/space)
"es" = (
/obj/structure/table/steel,
/obj/structure/rack/dark,
/turf/simulated/floor/wood/yew,
/area/space)
"fr" = (
/obj/structure/flora/bush/grassybush,
/turf/exterior/dry,
/area/space)
"fO" = (
/obj/structure/table/woodentable,
/turf/simulated/floor/wood/yew,
/area/space)
"hF" = (
/turf/simulated/wall/wood,
/area/space)
"hT" = (
/turf/exterior/concrete/reinforced/damaged,
/area/space)
"iv" = (
/obj/structure/bed/chair/comfy/red{
	dir = 8
	},
/turf/simulated/floor/wood/yew,
/area/space)
"iz" = (
/obj/structure/bed/chair/wood{
	dir = 8
	},
/turf/simulated/floor/wood/yew,
/area/space)
"iH" = (
/obj/structure/rack/dark,
/turf/simulated/wall/wood,
/area/space)
"lp" = (
/obj/structure/table/woodentable,
/obj/item/chems/ivbag/blood/OMinus,
/turf/simulated/floor/wood/yew,
/area/space)
"lt" = (
/obj/structure/hygiene/sink,
/obj/structure/hygiene/sink,
/obj/structure/table/steel,
/turf/simulated/floor/wood/yew,
/area/space)
"lH" = (
/obj/structure/hygiene/shower{
	dir = 4
	},
/turf/simulated/floor/wood/yew,
/area/space)
"mJ" = (
/obj/structure/table/woodentable,
/obj/item/modular_computer/laptop,
/turf/simulated/floor/wood/yew,
/area/space)
"or" = (
/obj/structure/door/wood,
/turf/simulated/floor/wood/usedup,
/area/space)
"oX" = (
/turf/exterior/dirt,
/area/space)
"pi" = (
/turf/unsimulated/mineral,
/area/space)
"qH" = (
/obj/structure/bed,
/turf/simulated/floor/wood/yew,
/area/space)
"qM" = (
/obj/structure/hygiene/sink{
	dir = 1
	},
/turf/simulated/wall/wood,
/area/space)
"rA" = (
/obj/structure/curtain/medical,
/turf/simulated/floor/wood/yew,
/area/space)
"tG" = (
/obj/structure/flora/bush/sparsegrass,
/turf/exterior/sand,
/area/space)
"tI" = (
/obj/structure/closet/secure_closet/freezer/kitchen,
/turf/simulated/floor/wood/yew,
/area/space)
"vk" = (
/obj/structure/table/steel,
/turf/simulated/floor/wood/yew,
/area/space)
"xk" = (
/obj/structure/bookcase,
/turf/simulated/floor/wood/yew,
/area/space)
"AX" = (
/obj/structure/table/steel,
/obj/machinery/microwave,
/turf/simulated/floor/wood/yew,
/area/space)
"Bp" = (
/obj/structure/closet/secure_closet/freezer/fridge,
/turf/simulated/floor/wood/yew,
/area/space)
"BH" = (
/obj/structure/curtain/medical,
/obj/structure/curtain/medical,
/turf/simulated/floor/wood/yew,
/area/space)
"BL" = (
/obj/structure/rack/dark,
/obj/structure/rack/dark,
/turf/simulated/floor/wood/yew,
/area/space)
"Dr" = (
/obj/structure/iv_drip,
/turf/simulated/floor/wood/yew,
/area/space)
"Dz" = (
/obj/structure/door/wood,
/turf/simulated/floor/wood/yew,
/area/space)
"DS" = (
/obj/structure/bed/chair{
	dir = 8
	},
/turf/simulated/floor/wood/yew,
/area/space)
"DT" = (
/obj/structure/barricade,
/turf/exterior/dry,
/area/space)
"GN" = (
/obj/structure/bed/chair/wood{
	dir = 4
	},
/turf/simulated/floor/wood/yew,
/area/space)
"HE" = (
/obj/structure/flora/pottedplant/tall,
/turf/exterior/dry,
/area/space)
"Jb" = (
/obj/structure/coatrack,
/turf/simulated/floor/wood/yew,
/area/space)
"JC" = (
/obj/item/stack/flag/blue,
/turf/exterior/dry,
/area/space)
"JJ" = (
/turf/exterior/concrete/reinforced/road,
/area/space)
"JN" = (
/obj/structure/window/basic/full,
/turf/exterior/dirt,
/area/space)
"JO" = (
/obj/structure/door/wood,
/obj/structure/tape_barricade/door,
/obj/structure/barricade,
/turf/simulated/floor/wood/yew,
/area/space)
"KB" = (
/obj/structure/bed/sofa/right/beige{
	dir = 8
	},
/turf/simulated/floor/wood/yew,
/area/space)
"KE" = (
/obj/structure/flora/stump/tree/dead,
/turf/exterior/dry,
/area/space)
"Lp" = (
/obj/structure/bed/roller,
/turf/simulated/floor/wood/yew,
/area/space)
"MU" = (
/obj/structure/bed/chair/comfy/red{
	dir = 4
	},
/turf/simulated/floor/wood/yew,
/area/space)
"NC" = (
/turf/simulated/floor/wood/yew,
/area/space)
"ND" = (
/obj/structure/table/woodentable,
/obj/item/storage/box/bloodpacks,
/turf/simulated/floor/wood/yew,
/area/space)
"NZ" = (
/obj/structure/table/steel,
/obj/item/boombox,
/turf/simulated/floor/wood/yew,
/area/space)
"OI" = (
/turf/simulated/floor/wood/usedup,
/area/space)
"Ph" = (
/turf/exterior/sand,
/area/space)
"Px" = (
/obj/structure/gravemarker,
/turf/unsimulated/mineral,
/area/space)
"QE" = (
/obj/structure/flora/plant,
/turf/exterior/dry,
/area/space)
"QP" = (
/obj/structure/closet/wardrobe,
/turf/simulated/floor/wood/yew,
/area/space)
"UZ" = (
/turf/exterior/dry,
/area/space)
"Vh" = (
/obj/structure/flora/bush/grassybush,
/turf/exterior/sand,
/area/space)
"VK" = (
/obj/item/chems/ivbag/blood/OMinus,
/obj/structure/table,
/obj/item/storage/firstaid/surgery/ghetto,
/turf/simulated/floor/wood/yew,
/area/space)
"VP" = (
/obj/structure/hygiene/toilet{
	dir = 8
	},
/turf/simulated/floor/wood/yew,
/area/space)
"XN" = (
/obj/structure/rack/dark,
/turf/simulated/floor/wood/yew,
/area/space)
"XU" = (
/obj/effect/overlay/palmtree_l,
/turf/exterior/dry,
/area/space)
"YG" = (
/obj/structure/flora/bush/sparsegrass,
/turf/exterior/dry,
/area/space)

(1,1,1) = {"
UZ
UZ
UZ
UZ
UZ
UZ
UZ
UZ
UZ
UZ
UZ
UZ
UZ
UZ
UZ
UZ
UZ
UZ
UZ
UZ
UZ
UZ
UZ
UZ
UZ
UZ
UZ
UZ
UZ
UZ
UZ
UZ
UZ
UZ
UZ
UZ
UZ
UZ
UZ
UZ
UZ
UZ
UZ
Ph
Ph
pi
pi
pi
pi
pi
pi
pi
pi
pi
pi
pi
pi
pi
pi
pi
pi
pi
pi
pi
"}
(2,1,1) = {"
UZ
UZ
UZ
UZ
UZ
UZ
UZ
UZ
UZ
UZ
UZ
UZ
KE
UZ
UZ
UZ
UZ
UZ
UZ
UZ
UZ
UZ
YG
UZ
UZ
KE
UZ
UZ
UZ
UZ
UZ
UZ
UZ
UZ
UZ
UZ
UZ
UZ
UZ
UZ
UZ
UZ
UZ
Ph
Ph
Ph
pi
pi
pi
pi
pi
pi
pi
pi
pi
pi
pi
pi
pi
pi
pi
pi
pi
pi
"}
(3,1,1) = {"
UZ
UZ
UZ
UZ
UZ
UZ
UZ
UZ
UZ
UZ
UZ
UZ
UZ
UZ
UZ
UZ
UZ
UZ
UZ
UZ
UZ
UZ
UZ
UZ
UZ
UZ
UZ
Ph
UZ
UZ
UZ
UZ
UZ
UZ
UZ
UZ
UZ
UZ
UZ
UZ
YG
UZ
UZ
UZ
Ph
Ph
Ph
pi
pi
pi
pi
pi
pi
pi
pi
pi
pi
pi
pi
pi
pi
pi
pi
pi
"}
(4,1,1) = {"
UZ
UZ
UZ
YG
UZ
UZ
UZ
UZ
UZ
UZ
UZ
UZ
UZ
UZ
YG
YG
UZ
UZ
UZ
UZ
UZ
UZ
UZ
UZ
UZ
UZ
UZ
Ph
Ph
JJ
JJ
UZ
UZ
UZ
UZ
UZ
UZ
UZ
UZ
UZ
UZ
UZ
UZ
UZ
UZ
Ph
Ph
Ph
pi
pi
pi
pi
pi
pi
pi
pi
pi
pi
pi
pi
pi
pi
pi
pi
"}
(5,1,1) = {"
UZ
UZ
UZ
UZ
UZ
UZ
UZ
UZ
UZ
UZ
UZ
UZ
UZ
UZ
UZ
UZ
UZ
UZ
UZ
UZ
UZ
UZ
UZ
HE
UZ
UZ
Ph
Ph
JJ
JJ
JJ
JJ
JJ
JJ
JJ
JJ
Ph
Ph
UZ
UZ
UZ
UZ
UZ
UZ
UZ
UZ
Ph
Ph
Ph
pi
pi
pi
pi
pi
pi
pi
pi
pi
pi
pi
pi
pi
pi
pi
"}
(6,1,1) = {"
UZ
UZ
UZ
bD
UZ
UZ
UZ
UZ
UZ
UZ
UZ
UZ
UZ
UZ
UZ
UZ
KE
UZ
UZ
UZ
UZ
UZ
UZ
UZ
UZ
Ph
Ph
Ph
JJ
JJ
JJ
JJ
JJ
JJ
JJ
Ph
Ph
UZ
UZ
UZ
UZ
UZ
UZ
UZ
UZ
UZ
UZ
Ph
Ph
Ph
pi
pi
pi
pi
pi
Px
pi
pi
pi
pi
pi
pi
pi
pi
"}
(7,1,1) = {"
UZ
UZ
bD
UZ
UZ
UZ
UZ
UZ
UZ
UZ
UZ
UZ
UZ
UZ
UZ
UZ
UZ
UZ
UZ
UZ
UZ
UZ
UZ
UZ
Ph
Ph
Ph
JJ
JJ
JJ
JJ
JJ
hT
JJ
JJ
Ph
Ph
UZ
UZ
UZ
UZ
UZ
UZ
UZ
UZ
UZ
UZ
UZ
Ph
Ph
Ph
Ph
pi
pi
pi
pi
pi
pi
pi
pi
pi
pi
pi
pi
"}
(8,1,1) = {"
UZ
UZ
UZ
UZ
UZ
UZ
UZ
UZ
UZ
UZ
UZ
UZ
UZ
UZ
UZ
UZ
UZ
UZ
UZ
UZ
UZ
UZ
UZ
UZ
Ph
Ph
JJ
JJ
JJ
JJ
JJ
hT
JJ
JJ
Ph
Ph
Ph
UZ
UZ
HE
UZ
UZ
UZ
UZ
UZ
UZ
UZ
UZ
UZ
UZ
Ph
Ph
Ph
pi
pi
pi
pi
pi
pi
pi
pi
pi
pi
pi
"}
(9,1,1) = {"
UZ
UZ
bD
UZ
bD
UZ
UZ
UZ
UZ
UZ
UZ
YG
UZ
UZ
UZ
UZ
UZ
UZ
UZ
UZ
YG
UZ
UZ
Ph
Ph
Ph
JJ
JJ
hT
JJ
JJ
JJ
JJ
JJ
Ph
Ph
UZ
UZ
UZ
UZ
UZ
UZ
UZ
UZ
UZ
UZ
UZ
UZ
UZ
UZ
UZ
Ph
Ph
Ph
Ph
pi
pi
pi
pi
pi
pi
pi
pi
pi
"}
(10,1,1) = {"
UZ
bD
UZ
UZ
UZ
UZ
UZ
UZ
UZ
UZ
UZ
UZ
UZ
UZ
UZ
UZ
UZ
UZ
UZ
UZ
UZ
UZ
Ph
Ph
Ph
JJ
JJ
JJ
JJ
JJ
JJ
JJ
JJ
Ph
Ph
Ph
UZ
UZ
UZ
UZ
UZ
fr
UZ
UZ
UZ
UZ
UZ
UZ
UZ
UZ
UZ
UZ
Ph
Ph
Ph
pi
pi
pi
pi
pi
pi
pi
pi
pi
"}
(11,1,1) = {"
UZ
UZ
UZ
UZ
UZ
UZ
UZ
UZ
UZ
UZ
UZ
UZ
UZ
UZ
UZ
UZ
UZ
UZ
UZ
UZ
UZ
Ph
Ph
Ph
JJ
JJ
JJ
JJ
JJ
JJ
JJ
JJ
JJ
Ph
Ph
UZ
UZ
UZ
UZ
UZ
UZ
UZ
UZ
UZ
UZ
UZ
UZ
UZ
UZ
UZ
UZ
UZ
UZ
tG
Ph
pi
pi
pi
pi
pi
pi
pi
pi
pi
"}
(12,1,1) = {"
UZ
UZ
UZ
UZ
UZ
UZ
UZ
UZ
UZ
UZ
UZ
UZ
UZ
hF
hF
hF
hF
UZ
UZ
Ph
UZ
Ph
Ph
Ph
JJ
JJ
JJ
JJ
JJ
JJ
JJ
JJ
Ph
Ph
Ph
UZ
UZ
UZ
UZ
UZ
UZ
UZ
UZ
UZ
UZ
UZ
UZ
UZ
UZ
UZ
UZ
UZ
Ph
Ph
Ph
pi
pi
pi
oX
oX
oX
pi
pi
pi
"}
(13,1,1) = {"
UZ
UZ
UZ
UZ
fr
fr
KE
UZ
UZ
UZ
UZ
UZ
UZ
hF
qH
Bp
hF
UZ
Ph
pi
Ph
Ph
Ph
JJ
JJ
JJ
JJ
JJ
hT
JJ
JJ
Ph
Ph
Ph
UZ
UZ
UZ
UZ
UZ
KE
UZ
UZ
UZ
UZ
UZ
UZ
UZ
UZ
UZ
UZ
UZ
Ph
Ph
pi
pi
pi
pi
pi
oX
oX
oX
oX
pi
pi
"}
(14,1,1) = {"
UZ
UZ
UZ
UZ
UZ
UZ
UZ
UZ
UZ
UZ
UZ
UZ
UZ
hF
NC
NC
hF
Ph
pi
Ph
Ph
Ph
Ph
JJ
JJ
JJ
JJ
JJ
JJ
JJ
Ph
Ph
Ph
UZ
UZ
UZ
YG
UZ
UZ
UZ
UZ
UZ
UZ
UZ
UZ
UZ
UZ
UZ
UZ
fr
UZ
Ph
Ph
pi
pi
pi
pi
pi
pi
oX
oX
oX
oX
pi
"}
(15,1,1) = {"
UZ
KE
UZ
UZ
UZ
UZ
UZ
UZ
UZ
UZ
hF
hF
hF
hF
hF
NC
hF
Ph
pi
Vh
Ph
Ph
JJ
JJ
JJ
JJ
JJ
JJ
JJ
Ph
Ph
Ph
YG
UZ
KE
UZ
UZ
UZ
UZ
UZ
UZ
UZ
UZ
UZ
UZ
UZ
UZ
UZ
UZ
UZ
Ph
Ph
pi
pi
pi
pi
pi
pi
pi
oX
oX
oX
oX
pi
"}
(16,1,1) = {"
UZ
UZ
UZ
UZ
UZ
UZ
UZ
UZ
UZ
UZ
JN
NZ
vk
NC
NC
NC
JN
UZ
cM
Ph
Ph
JJ
JJ
JJ
JJ
JJ
JJ
JJ
Ph
Ph
Ph
UZ
UZ
UZ
UZ
UZ
UZ
UZ
UZ
UZ
UZ
UZ
UZ
UZ
UZ
UZ
UZ
UZ
UZ
UZ
Ph
Ph
pi
pi
pi
pi
pi
pi
pi
pi
oX
oX
pi
pi
"}
(17,1,1) = {"
UZ
UZ
UZ
UZ
UZ
UZ
UZ
UZ
UZ
UZ
hF
DS
NC
NC
NC
NC
hF
UZ
Ph
Ph
Ph
JJ
JJ
JJ
JJ
JJ
JJ
JJ
Ph
Ph
Vh
UZ
UZ
UZ
UZ
UZ
UZ
UZ
UZ
UZ
UZ
YG
UZ
UZ
UZ
UZ
YG
UZ
UZ
UZ
Ph
Ph
pi
pi
pi
pi
pi
pi
pi
pi
oX
oX
pi
pi
"}
(18,1,1) = {"
UZ
UZ
UZ
UZ
UZ
UZ
UZ
UZ
YG
UZ
hF
NC
NC
es
es
es
hF
UZ
Ph
Ph
JJ
JJ
JJ
JJ
JJ
JJ
JJ
Ph
Ph
Ph
UZ
hF
hF
hF
hF
JN
hF
hF
UZ
UZ
UZ
UZ
UZ
UZ
UZ
UZ
UZ
UZ
UZ
UZ
Ph
Ph
pi
pi
pi
pi
pi
pi
oX
pi
oX
pi
pi
pi
"}
(19,1,1) = {"
UZ
UZ
fr
HE
UZ
UZ
UZ
UZ
UZ
UZ
hF
XN
NC
NC
NC
XN
hF
Ph
Ph
Ph
JJ
JJ
hT
hT
JJ
JJ
Ph
Ph
Ph
HE
UZ
hF
qH
NC
rA
mJ
fO
hF
UZ
UZ
UZ
UZ
UZ
UZ
UZ
UZ
UZ
UZ
UZ
UZ
Ph
Ph
pi
pi
pi
pi
pi
pi
oX
oX
oX
pi
pi
pi
"}
(20,1,1) = {"
UZ
UZ
UZ
UZ
UZ
UZ
UZ
UZ
UZ
UZ
hF
XN
NC
XN
NC
BL
hF
Ph
Ph
JJ
JJ
JJ
JJ
JJ
hT
JJ
Ph
Ph
Ph
UZ
UZ
JN
Dr
iz
BH
NC
NC
hF
UZ
UZ
UZ
UZ
UZ
UZ
UZ
UZ
UZ
UZ
UZ
UZ
UZ
Ph
Ph
pi
pi
pi
pi
oX
oX
pi
pi
pi
pi
pi
"}
(21,1,1) = {"
UZ
UZ
UZ
UZ
UZ
UZ
YG
UZ
UZ
UZ
JN
XN
NC
NC
NC
XN
JN
Ph
JJ
JJ
JJ
JJ
JJ
JJ
JJ
Ph
Ph
Ph
fr
UZ
UZ
JN
Lp
NC
NC
VK
NC
hF
hF
hF
iH
hF
hF
hF
DT
DT
DT
DT
DT
DT
UZ
Ph
Ph
pi
pi
oX
pi
pi
oX
pi
pi
pi
pi
pi
"}
(22,1,1) = {"
UZ
UZ
UZ
UZ
UZ
UZ
UZ
UZ
UZ
UZ
hF
hF
JN
Dz
JN
hF
hF
Ph
JJ
JJ
JJ
JJ
JJ
JJ
Ph
Ph
Ph
UZ
UZ
UZ
UZ
hF
lp
ND
NC
ec
Dr
hF
xk
NC
MU
NC
MU
hF
UZ
UZ
UZ
UZ
UZ
DT
UZ
Ph
pi
pi
pi
oX
pi
pi
oX
pi
pi
pi
pi
pi
"}
(23,1,1) = {"
UZ
Ph
Ph
Ph
Ph
Ph
Ph
Ph
Ph
Ph
Ph
Ph
cM
UZ
Ph
Ph
Ph
JJ
JJ
JJ
JJ
JJ
JJ
JJ
Ph
Ph
Ph
UZ
UZ
UZ
DT
hF
hF
iH
NC
NC
NC
NC
NC
NC
NC
NC
fO
JN
UZ
QE
UZ
cq
UZ
DT
UZ
Ph
pi
pi
oX
oX
pi
pi
oX
oX
pi
oX
pi
pi
"}
(24,1,1) = {"
Ph
Ph
Ph
Ph
Ph
Ph
Ph
Ph
Ph
Vh
Ph
Ph
Ph
UZ
Ph
Ph
tG
JJ
JJ
JJ
JJ
JJ
JJ
Ph
Ph
tG
UZ
UZ
UZ
UZ
DT
OI
OI
iH
NC
bS
NC
hF
NC
an
KB
NC
iv
JN
UZ
UZ
bB
UZ
UZ
DT
UZ
Ph
pi
oX
oX
oX
pi
pi
oX
oX
oX
oX
pi
pi
"}
(25,1,1) = {"
Ph
Ph
JJ
JJ
JJ
JJ
JJ
JJ
JJ
JJ
JJ
JJ
JJ
JJ
JJ
JJ
JJ
JJ
JJ
JJ
JJ
JJ
JJ
Ph
Ph
Ph
UZ
UZ
UZ
UZ
DT
OI
hF
hF
NC
hF
hF
hF
hF
hF
NC
NC
XN
JN
UZ
UZ
UZ
UZ
UZ
DT
UZ
Ph
pi
oX
pi
oX
oX
pi
pi
pi
pi
oX
pi
pi
"}
(26,1,1) = {"
Ph
JJ
JJ
JJ
JJ
JJ
JJ
JJ
hT
JJ
JJ
JJ
JJ
JJ
JJ
JJ
JJ
JJ
JJ
JJ
JJ
JJ
Ph
Ph
Ph
UZ
UZ
UZ
UZ
UZ
OI
OI
or
NC
NC
Jb
XN
NC
NC
NC
NC
NC
NC
JO
UZ
UZ
YG
UZ
UZ
DT
UZ
UZ
oX
oX
pi
oX
oX
oX
oX
pi
pi
oX
pi
pi
"}
(27,1,1) = {"
JJ
JJ
JJ
JJ
JJ
hT
JJ
JJ
JJ
hT
hT
hT
JJ
JJ
JJ
JJ
JJ
JJ
JJ
JJ
JJ
JJ
Ph
Ph
Ph
UZ
UZ
UZ
UZ
UZ
DT
OI
hF
hF
NC
NC
NC
NC
NC
NC
hF
hF
hF
hF
UZ
UZ
UZ
UZ
UZ
UZ
UZ
Ph
Ph
pi
pi
pi
pi
pi
oX
oX
oX
oX
pi
pi
"}
(28,1,1) = {"
JJ
JJ
JJ
JJ
JJ
hT
JJ
JJ
JJ
JJ
JJ
JJ
hT
JJ
JJ
JJ
JJ
JJ
JJ
JJ
JJ
JJ
Ph
Vh
UZ
UZ
UZ
UZ
UZ
JC
DT
OI
OI
hF
hF
hF
hF
hF
hF
NC
iH
UZ
UZ
UZ
UZ
UZ
UZ
UZ
UZ
UZ
UZ
Ph
Ph
pi
pi
pi
pi
pi
pi
oX
oX
pi
pi
pi
"}
(29,1,1) = {"
JJ
JJ
JJ
JJ
hT
JJ
JJ
JJ
JJ
JJ
JJ
JJ
JJ
JJ
JJ
JJ
JJ
JJ
JJ
JJ
JJ
JJ
Ph
Ph
UZ
KE
UZ
UZ
UZ
UZ
DT
hF
hF
hF
hF
hF
hF
hF
hF
NC
iH
hF
hF
hF
hF
hF
UZ
HE
UZ
DT
UZ
Ph
Ph
pi
pi
pi
pi
pi
pi
pi
oX
pi
pi
pi
"}
(30,1,1) = {"
JJ
JJ
JJ
Ph
Ph
Ph
Ph
Ph
Ph
Ph
Ph
Ph
Ph
Ph
Ph
Ph
Ph
JJ
JJ
JJ
JJ
JJ
Ph
Ph
UZ
UZ
UZ
UZ
UZ
YG
UZ
hF
XN
NC
fO
MU
NC
NC
hF
NC
hF
NC
vk
AX
tI
hF
UZ
UZ
UZ
DT
UZ
Ph
Ph
pi
pi
pi
pi
pi
pi
pi
oX
pi
pi
pi
"}
(31,1,1) = {"
JJ
JJ
Ph
Ph
Ph
Ph
Ph
Ph
Ph
tG
Ph
Ph
Ph
Vh
Ph
tG
Ph
JJ
JJ
hT
JJ
JJ
Ph
cM
UZ
UZ
UZ
UZ
UZ
UZ
UZ
JN
qH
NC
NC
NC
NC
NC
NC
NC
hF
NC
NC
NC
vk
hF
UZ
UZ
UZ
DT
UZ
UZ
Ph
pi
pi
pi
pi
pi
pi
oX
oX
pi
pi
pi
"}
(32,1,1) = {"
JJ
Ph
Ph
Ph
UZ
UZ
UZ
Ph
pi
pi
Ph
UZ
UZ
UZ
cM
Ph
Ph
JJ
JJ
JJ
JJ
JJ
Ph
Ph
Ph
UZ
UZ
UZ
UZ
UZ
UZ
JN
qH
NC
NC
NC
hF
hF
hF
NC
hF
NC
GN
NC
lt
JN
UZ
XU
UZ
DT
UZ
UZ
Ph
pi
pi
pi
pi
pi
oX
oX
oX
oX
pi
pi
"}
(33,1,1) = {"
JJ
Ph
Ph
UZ
UZ
UZ
Ph
pi
pi
Ph
YG
UZ
KE
UZ
UZ
Ph
Vh
JJ
JJ
JJ
JJ
JJ
Ph
Ph
Ph
pi
Ph
Ph
UZ
UZ
UZ
hF
XN
NC
NC
QP
qM
lH
Dz
NC
NC
NC
fO
NC
vk
JN
UZ
UZ
XU
DT
UZ
UZ
Ph
Ph
pi
pi
pi
pi
oX
oX
oX
oX
pi
pi
"}
(34,1,1) = {"
Ph
Ph
Ph
UZ
UZ
UZ
Ph
pi
Ph
UZ
UZ
UZ
UZ
UZ
Ph
Ph
Ph
JJ
JJ
JJ
JJ
JJ
Ph
Ph
UZ
Ph
pi
pi
Ph
UZ
UZ
hF
hF
hF
hF
hF
hF
VP
hF
NC
hF
NC
iz
NC
NC
hF
YG
UZ
UZ
DT
UZ
UZ
Ph
Ph
pi
pi
pi
pi
oX
oX
oX
oX
oX
pi
"}
(35,1,1) = {"
Ph
Vh
UZ
UZ
UZ
UZ
UZ
Ph
fr
UZ
UZ
UZ
Ph
Ph
pi
Ph
Ph
JJ
JJ
JJ
JJ
JJ
Ph
Ph
UZ
Ph
pi
pi
pi
Ph
UZ
UZ
UZ
UZ
UZ
UZ
hF
hF
hF
hF
hF
hF
hF
hF
hF
hF
DT
DT
DT
DT
UZ
UZ
tG
Ph
pi
pi
pi
pi
oX
oX
oX
oX
oX
pi
"}
(36,1,1) = {"
Ph
Ph
UZ
UZ
YG
UZ
UZ
UZ
UZ
UZ
UZ
Ph
pi
pi
pi
Ph
Ph
JJ
JJ
JJ
JJ
JJ
Ph
Ph
UZ
UZ
Ph
pi
pi
pi
Ph
UZ
UZ
UZ
UZ
UZ
UZ
UZ
UZ
UZ
UZ
UZ
UZ
UZ
UZ
UZ
UZ
UZ
UZ
UZ
UZ
UZ
UZ
Ph
pi
pi
pi
pi
pi
oX
oX
oX
pi
pi
"}
(37,1,1) = {"
UZ
UZ
UZ
UZ
UZ
UZ
UZ
Ph
UZ
UZ
Ph
pi
pi
pi
Ph
Ph
Ph
JJ
JJ
JJ
JJ
JJ
Ph
Ph
UZ
UZ
UZ
Ph
pi
pi
pi
Ph
Ph
Ph
Ph
Ph
Ph
UZ
UZ
UZ
UZ
UZ
UZ
UZ
UZ
UZ
UZ
UZ
UZ
UZ
UZ
UZ
UZ
Ph
pi
pi
pi
pi
pi
pi
pi
pi
pi
pi
"}
(38,1,1) = {"
UZ
HE
UZ
UZ
UZ
UZ
Ph
pi
Ph
UZ
UZ
Ph
Ph
Ph
UZ
Ph
Ph
JJ
JJ
JJ
JJ
JJ
Ph
Ph
UZ
UZ
UZ
YG
Ph
pi
pi
pi
pi
pi
pi
pi
pi
Ph
UZ
UZ
UZ
UZ
UZ
UZ
UZ
UZ
UZ
UZ
UZ
UZ
UZ
UZ
UZ
Ph
pi
pi
pi
pi
pi
pi
pi
pi
pi
pi
"}
(39,1,1) = {"
UZ
UZ
HE
UZ
UZ
UZ
Ph
pi
pi
Ph
UZ
UZ
UZ
UZ
UZ
Ph
Ph
JJ
JJ
JJ
JJ
JJ
Ph
Ph
UZ
UZ
UZ
UZ
UZ
Ph
pi
pi
pi
pi
pi
pi
pi
pi
Ph
UZ
YG
UZ
UZ
UZ
UZ
UZ
UZ
UZ
UZ
UZ
UZ
UZ
UZ
Ph
pi
pi
pi
pi
pi
pi
pi
pi
pi
pi
"}
(40,1,1) = {"
UZ
UZ
UZ
UZ
UZ
UZ
UZ
Ph
Ph
UZ
UZ
UZ
UZ
UZ
UZ
Ph
Ph
JJ
JJ
JJ
JJ
JJ
Ph
Ph
UZ
UZ
UZ
UZ
UZ
UZ
Ph
Ph
Ph
pi
pi
pi
pi
pi
pi
Ph
UZ
UZ
UZ
UZ
UZ
UZ
UZ
UZ
UZ
UZ
UZ
UZ
UZ
Ph
pi
pi
pi
pi
pi
pi
pi
pi
pi
pi
"}
(41,1,1) = {"
UZ
UZ
UZ
UZ
KE
UZ
UZ
UZ
UZ
UZ
UZ
UZ
UZ
UZ
UZ
Ph
Ph
JJ
JJ
JJ
JJ
JJ
Ph
Ph
UZ
UZ
UZ
UZ
UZ
UZ
UZ
UZ
UZ
Ph
Ph
Ph
Ph
Ph
Ph
UZ
UZ
UZ
UZ
UZ
UZ
UZ
UZ
UZ
UZ
UZ
UZ
UZ
UZ
Ph
pi
pi
pi
pi
pi
pi
pi
pi
pi
pi
"}
(42,1,1) = {"
UZ
UZ
UZ
UZ
UZ
UZ
UZ
UZ
UZ
UZ
UZ
UZ
UZ
UZ
UZ
Ph
Ph
JJ
JJ
JJ
JJ
JJ
Ph
Ph
fr
UZ
UZ
UZ
YG
UZ
UZ
UZ
YG
UZ
UZ
UZ
UZ
UZ
UZ
UZ
UZ
UZ
UZ
UZ
UZ
UZ
UZ
UZ
UZ
UZ
UZ
UZ
UZ
Ph
Ph
pi
pi
pi
pi
pi
pi
pi
pi
pi
"}
(43,1,1) = {"
UZ
UZ
UZ
UZ
UZ
UZ
UZ
UZ
UZ
UZ
UZ
UZ
UZ
UZ
UZ
Ph
Ph
JJ
JJ
JJ
JJ
JJ
Ph
Ph
UZ
UZ
UZ
UZ
UZ
UZ
UZ
UZ
UZ
UZ
UZ
UZ
UZ
UZ
UZ
UZ
UZ
UZ
UZ
UZ
UZ
UZ
UZ
UZ
UZ
UZ
UZ
UZ
UZ
Ph
Ph
pi
pi
pi
pi
pi
pi
pi
pi
pi
"}
(44,1,1) = {"
UZ
UZ
UZ
UZ
UZ
UZ
YG
UZ
UZ
UZ
UZ
KE
UZ
UZ
UZ
Vh
Ph
JJ
JJ
JJ
JJ
JJ
Ph
Ph
UZ
UZ
UZ
UZ
UZ
UZ
UZ
UZ
UZ
UZ
UZ
UZ
UZ
UZ
UZ
UZ
UZ
UZ
UZ
UZ
UZ
fr
fr
UZ
UZ
UZ
UZ
UZ
UZ
UZ
Ph
Ph
pi
pi
pi
pi
pi
pi
pi
pi
"}
(45,1,1) = {"
UZ
UZ
UZ
UZ
UZ
UZ
UZ
UZ
UZ
UZ
UZ
UZ
YG
UZ
UZ
Ph
Ph
JJ
JJ
JJ
JJ
JJ
Ph
Ph
UZ
UZ
UZ
UZ
UZ
UZ
UZ
UZ
UZ
UZ
UZ
UZ
UZ
UZ
UZ
UZ
UZ
UZ
UZ
UZ
UZ
UZ
UZ
UZ
UZ
UZ
UZ
UZ
UZ
UZ
Ph
Ph
pi
pi
pi
pi
pi
pi
pi
pi
"}
(46,1,1) = {"
UZ
UZ
UZ
UZ
UZ
YG
UZ
UZ
UZ
UZ
UZ
UZ
UZ
UZ
UZ
Ph
Ph
JJ
hT
JJ
JJ
JJ
Ph
Ph
UZ
UZ
UZ
UZ
UZ
UZ
UZ
UZ
UZ
UZ
UZ
UZ
UZ
UZ
UZ
UZ
UZ
UZ
UZ
UZ
UZ
UZ
UZ
UZ
UZ
UZ
UZ
UZ
UZ
UZ
UZ
Ph
Ph
pi
pi
pi
pi
pi
pi
pi
"}
(47,1,1) = {"
UZ
UZ
UZ
UZ
UZ
UZ
UZ
UZ
UZ
UZ
UZ
UZ
UZ
UZ
UZ
Ph
Ph
JJ
JJ
hT
JJ
JJ
Ph
Ph
UZ
UZ
UZ
UZ
UZ
UZ
UZ
UZ
fr
UZ
UZ
UZ
UZ
UZ
UZ
UZ
UZ
UZ
YG
UZ
UZ
UZ
UZ
UZ
UZ
UZ
UZ
UZ
UZ
UZ
UZ
Ph
Ph
pi
pi
pi
pi
pi
pi
pi
"}
(48,1,1) = {"
UZ
UZ
UZ
UZ
UZ
UZ
UZ
UZ
UZ
UZ
UZ
UZ
UZ
UZ
UZ
Ph
Ph
JJ
JJ
JJ
JJ
JJ
Ph
Ph
UZ
UZ
YG
UZ
UZ
UZ
UZ
KE
UZ
UZ
UZ
UZ
UZ
UZ
UZ
UZ
UZ
UZ
UZ
YG
UZ
UZ
UZ
UZ
UZ
UZ
UZ
UZ
UZ
UZ
UZ
UZ
Ph
Ph
pi
pi
pi
pi
pi
pi
"}
(49,1,1) = {"
UZ
UZ
UZ
YG
UZ
UZ
UZ
UZ
YG
UZ
UZ
UZ
UZ
UZ
UZ
Ph
Ph
JJ
JJ
JJ
JJ
JJ
Ph
Ph
UZ
UZ
UZ
UZ
UZ
UZ
UZ
UZ
UZ
UZ
UZ
UZ
UZ
UZ
UZ
UZ
UZ
UZ
UZ
UZ
UZ
UZ
UZ
UZ
UZ
UZ
UZ
UZ
UZ
UZ
UZ
UZ
Ph
Ph
pi
pi
pi
pi
pi
pi
"}
(50,1,1) = {"
UZ
UZ
UZ
UZ
UZ
UZ
UZ
UZ
UZ
UZ
UZ
UZ
UZ
UZ
UZ
Ph
Ph
JJ
JJ
JJ
JJ
JJ
Ph
Ph
UZ
UZ
UZ
UZ
UZ
UZ
UZ
UZ
UZ
UZ
UZ
UZ
UZ
UZ
UZ
UZ
UZ
UZ
UZ
UZ
UZ
UZ
UZ
UZ
UZ
UZ
UZ
UZ
UZ
UZ
YG
UZ
UZ
Ph
pi
pi
pi
pi
pi
pi
"}
(51,1,1) = {"
UZ
UZ
UZ
UZ
UZ
UZ
UZ
UZ
UZ
UZ
UZ
UZ
UZ
UZ
UZ
Ph
Ph
JJ
JJ
JJ
JJ
JJ
Ph
Ph
UZ
UZ
UZ
UZ
UZ
UZ
UZ
UZ
UZ
UZ
UZ
UZ
UZ
UZ
UZ
UZ
UZ
UZ
UZ
UZ
UZ
UZ
UZ
UZ
UZ
UZ
UZ
UZ
UZ
UZ
UZ
UZ
UZ
Ph
pi
pi
pi
oX
pi
pi
"}
(52,1,1) = {"
UZ
UZ
UZ
UZ
UZ
UZ
UZ
UZ
UZ
UZ
UZ
UZ
UZ
UZ
UZ
Ph
Ph
JJ
JJ
JJ
JJ
JJ
Ph
Ph
UZ
UZ
UZ
UZ
UZ
UZ
UZ
UZ
UZ
UZ
UZ
UZ
UZ
UZ
UZ
UZ
UZ
UZ
UZ
UZ
UZ
UZ
UZ
UZ
UZ
UZ
UZ
UZ
UZ
UZ
UZ
UZ
UZ
Ph
Ph
pi
oX
oX
pi
pi
"}
(53,1,1) = {"
UZ
UZ
UZ
UZ
UZ
UZ
UZ
UZ
UZ
UZ
UZ
YG
UZ
UZ
UZ
UZ
UZ
UZ
UZ
UZ
UZ
UZ
UZ
UZ
UZ
UZ
UZ
UZ
UZ
UZ
UZ
UZ
UZ
UZ
UZ
UZ
UZ
UZ
UZ
UZ
UZ
UZ
UZ
UZ
UZ
UZ
UZ
UZ
UZ
UZ
UZ
UZ
UZ
UZ
UZ
UZ
UZ
UZ
Ph
pi
oX
pi
pi
pi
"}
(54,1,1) = {"
UZ
UZ
UZ
UZ
UZ
UZ
UZ
UZ
UZ
UZ
UZ
UZ
UZ
UZ
UZ
UZ
UZ
UZ
UZ
UZ
UZ
UZ
UZ
UZ
UZ
UZ
UZ
UZ
UZ
UZ
UZ
UZ
UZ
UZ
UZ
UZ
UZ
UZ
UZ
UZ
UZ
UZ
UZ
UZ
UZ
UZ
UZ
YG
UZ
UZ
UZ
UZ
UZ
UZ
UZ
UZ
UZ
UZ
UZ
oX
oX
pi
pi
pi
"}
(55,1,1) = {"
UZ
UZ
UZ
UZ
UZ
UZ
UZ
UZ
UZ
UZ
UZ
UZ
UZ
UZ
UZ
UZ
UZ
UZ
UZ
UZ
UZ
UZ
UZ
UZ
UZ
UZ
UZ
UZ
UZ
UZ
UZ
UZ
UZ
UZ
UZ
UZ
UZ
UZ
UZ
UZ
UZ
UZ
UZ
UZ
UZ
UZ
UZ
YG
UZ
UZ
UZ
UZ
UZ
UZ
UZ
UZ
UZ
UZ
Ph
pi
oX
oX
pi
pi
"}
(56,1,1) = {"
UZ
UZ
UZ
UZ
UZ
UZ
UZ
UZ
UZ
UZ
UZ
UZ
UZ
UZ
UZ
UZ
UZ
UZ
UZ
UZ
UZ
UZ
UZ
UZ
UZ
UZ
UZ
UZ
UZ
UZ
UZ
UZ
UZ
UZ
UZ
UZ
UZ
UZ
UZ
UZ
UZ
UZ
UZ
UZ
UZ
UZ
UZ
UZ
UZ
UZ
UZ
UZ
UZ
UZ
UZ
UZ
UZ
Ph
Ph
pi
pi
pi
pi
pi
"}
(57,1,1) = {"
UZ
UZ
UZ
UZ
UZ
UZ
UZ
UZ
UZ
UZ
UZ
UZ
UZ
UZ
UZ
UZ
UZ
UZ
UZ
UZ
UZ
UZ
UZ
UZ
UZ
UZ
UZ
UZ
UZ
UZ
YG
UZ
UZ
UZ
UZ
UZ
UZ
UZ
UZ
UZ
UZ
UZ
UZ
UZ
UZ
UZ
UZ
UZ
UZ
UZ
UZ
UZ
UZ
UZ
UZ
UZ
UZ
Ph
pi
pi
pi
pi
pi
pi
"}
(58,1,1) = {"
UZ
UZ
UZ
UZ
UZ
UZ
UZ
YG
UZ
UZ
UZ
UZ
UZ
UZ
UZ
UZ
UZ
UZ
UZ
UZ
UZ
UZ
UZ
UZ
UZ
UZ
UZ
UZ
UZ
UZ
UZ
UZ
UZ
UZ
UZ
UZ
UZ
UZ
UZ
UZ
UZ
UZ
UZ
UZ
UZ
UZ
UZ
UZ
UZ
UZ
UZ
UZ
UZ
UZ
UZ
UZ
Ph
Ph
pi
pi
pi
pi
pi
pi
"}
(59,1,1) = {"
UZ
UZ
UZ
UZ
UZ
UZ
UZ
UZ
UZ
UZ
UZ
UZ
UZ
UZ
UZ
UZ
UZ
UZ
UZ
UZ
UZ
UZ
UZ
UZ
UZ
UZ
UZ
UZ
UZ
UZ
UZ
UZ
UZ
UZ
UZ
UZ
UZ
UZ
UZ
UZ
UZ
UZ
UZ
UZ
UZ
UZ
UZ
UZ
UZ
UZ
UZ
UZ
UZ
UZ
UZ
UZ
Ph
Ph
pi
pi
pi
pi
pi
pi
"}
(60,1,1) = {"
UZ
UZ
UZ
UZ
UZ
UZ
UZ
UZ
UZ
UZ
UZ
UZ
UZ
UZ
UZ
UZ
UZ
UZ
UZ
UZ
UZ
UZ
UZ
UZ
UZ
UZ
UZ
UZ
UZ
UZ
UZ
UZ
UZ
UZ
UZ
UZ
UZ
UZ
UZ
UZ
UZ
UZ
UZ
UZ
UZ
UZ
UZ
UZ
UZ
UZ
UZ
UZ
UZ
UZ
UZ
UZ
Ph
Ph
pi
pi
pi
pi
pi
pi
"}
(61,1,1) = {"
UZ
UZ
UZ
UZ
UZ
UZ
UZ
UZ
UZ
UZ
UZ
UZ
UZ
UZ
UZ
UZ
YG
UZ
UZ
UZ
UZ
UZ
UZ
UZ
UZ
UZ
UZ
UZ
UZ
UZ
UZ
UZ
UZ
UZ
UZ
UZ
UZ
UZ
UZ
UZ
UZ
UZ
UZ
UZ
UZ
UZ
UZ
UZ
UZ
UZ
UZ
UZ
UZ
UZ
UZ
UZ
Ph
pi
pi
pi
pi
pi
pi
pi
"}
(62,1,1) = {"
UZ
UZ
UZ
UZ
UZ
UZ
UZ
UZ
UZ
UZ
UZ
UZ
UZ
UZ
UZ
UZ
UZ
UZ
UZ
UZ
UZ
UZ
UZ
UZ
UZ
UZ
UZ
UZ
UZ
UZ
UZ
UZ
UZ
UZ
UZ
UZ
UZ
UZ
UZ
UZ
UZ
UZ
UZ
UZ
UZ
UZ
UZ
UZ
UZ
UZ
UZ
UZ
UZ
UZ
UZ
Ph
Ph
pi
pi
pi
pi
pi
pi
pi
"}
(63,1,1) = {"
UZ
UZ
UZ
UZ
UZ
UZ
UZ
UZ
UZ
UZ
UZ
UZ
UZ
UZ
UZ
UZ
UZ
UZ
UZ
UZ
UZ
UZ
UZ
UZ
UZ
UZ
UZ
UZ
UZ
UZ
UZ
UZ
UZ
UZ
UZ
UZ
UZ
UZ
UZ
UZ
UZ
UZ
UZ
UZ
UZ
UZ
UZ
UZ
UZ
UZ
UZ
UZ
UZ
UZ
Ph
Ph
pi
pi
pi
pi
pi
pi
pi
pi
"}
(64,1,1) = {"
UZ
UZ
UZ
UZ
UZ
UZ
UZ
UZ
UZ
UZ
UZ
UZ
UZ
UZ
UZ
UZ
UZ
UZ
UZ
UZ
UZ
UZ
UZ
UZ
UZ
UZ
UZ
UZ
UZ
UZ
UZ
UZ
UZ
UZ
UZ
UZ
UZ
UZ
UZ
UZ
UZ
UZ
UZ
UZ
UZ
UZ
UZ
UZ
UZ
UZ
UZ
UZ
UZ
Ph
Ph
pi
pi
pi
pi
pi
pi
pi
pi
pi
"}
