"aa" = (/turf/simulated/ground/dry,/area/devmap)
"ab" = (/obj/structure/gravemarker,/turf/simulated/ground/dry,/area/devmap)
"ac" = (/obj/structure/flora/stump/tree/dead,/turf/simulated/ground/dry,/area/devmap)
"ad" = (/obj/structure/flora/pottedplant/tall,/turf/simulated/ground/dry,/area/devmap)
"ae" = (/obj/structure/flora/bush/grassybush,/turf/simulated/ground/dry,/area/devmap)
"af" = (/obj/structure/flora/bush/sparsegrass,/turf/simulated/ground/dry,/area/devmap)
"ag" = (/turf/space,/area/devmap)
"ah" = (/obj/item/stack/flag/blue,/turf/simulated/ground/dry,/area/devmap)
"ai" = (/obj/structure/barricade,/turf/simulated/ground/dry,/area/devmap)
"aj" = (/obj/structure/flora/plant,/turf/simulated/ground/dry,/area/devmap)
"ak" = (/obj/structure/flora/pottedplant/shoot,/turf/simulated/ground/dry,/area/devmap)
"al" = (/obj/structure/flora/pottedplant/smalltree,/turf/simulated/ground/dry,/area/devmap)
"am" = (/obj/effect/overlay/palmtree_l,/turf/simulated/ground/dry,/area/devmap)
"an" = (/obj/structure/gravemarker,/turf/unsimulated/mineral,/area/devmap)
"bS" = (/obj/structure/bed/chair/comfy/red{dir = 4},/turf/simulated/floor/wood/yew,/area/devmap)
"cq" = (/obj/structure/bed/chair/wood{dir = 4},/turf/simulated/floor/wood/yew,/area/devmap)
"cM" = (/obj/structure/flora/bush/sparsegrass,/turf/simulated/ground/sand,/area/devmap)
"ec" = (/obj/structure/bed/roller,/turf/simulated/floor/wood/yew,/area/devmap)
"fr" = (/obj/structure/table/steel,/obj/machinery/microwave,/turf/simulated/floor/wood/yew,/area/devmap)
"fO" = (/obj/structure/bed/chair{dir = 8},/turf/simulated/floor/wood/yew,/area/devmap)
"hF" = (/obj/structure/closet/wardrobe,/turf/simulated/floor/wood/yew,/area/devmap)
"hT" = (/obj/structure/closet/secure_closet/freezer/fridge,/turf/simulated/floor/wood/yew,/area/devmap)
"iv" = (/obj/structure/window/basic/full,/turf/simulated/ground/mud,/area/devmap)
"iz" = (/obj/structure/curtain/medical,/turf/simulated/floor/wood/yew,/area/devmap)
"iH" = (/obj/structure/iv_drip,/turf/simulated/floor/wood/yew,/area/devmap)
"lp" = (/obj/item/chems/ivbag/blood/OMinus,/obj/structure/table,/obj/item/storage/firstaid/surgery/ghetto,/turf/simulated/floor/wood/yew,/area/devmap)
"lt" = (/obj/structure/hygiene/shower{dir = 4},/turf/simulated/floor/wood/yew,/area/devmap)
"lH" = (/obj/structure/rack/dark,/turf/simulated/wall/wood,/area/devmap)
"mJ" = (/obj/structure/hygiene/toilet{dir = 8},/turf/simulated/floor/wood/yew,/area/devmap)
"oX" = (/turf/unsimulated/mineral,/area/devmap)
"pi" = (/turf/simulated/ground/mud,/area/devmap)
"qH" = (/turf/simulated/wall/wood,/area/devmap)
"rA" = (/obj/structure/table/woodentable,/turf/simulated/floor/wood/yew,/area/devmap)
"tG" = (/turf/simulated/ground/concrete/reinforced/road,/area/devmap)
"tI" = (/obj/structure/hygiene/sink,/obj/structure/hygiene/sink,/obj/structure/table/steel,/turf/simulated/floor/wood/yew,/area/devmap)
"AX" = (/obj/structure/curtain/medical,/obj/structure/curtain/medical,/turf/simulated/floor/wood/yew,/area/devmap)
"Bp" = (/obj/structure/coatrack,/turf/simulated/floor/wood/yew,/area/devmap)
"BH" = (/obj/structure/table/woodentable,/obj/item/modular_computer/laptop,/turf/simulated/floor/wood/yew,/area/devmap)
"BL" = (/obj/structure/bookcase,/turf/simulated/floor/wood/yew,/area/devmap)
"CT" = (/obj/structure/bed/sofa/right/beige{dir = 8},/turf/simulated/floor/wood/yew,/area/devmap)
"Dr" = (/obj/structure/hygiene/sink{dir = 1},/turf/simulated/wall/wood,/area/devmap)
"DS" = (/obj/structure/table/steel,/turf/simulated/floor/wood/yew,/area/devmap)
"DT" = (/turf/simulated/floor/wood/usedup,/area/devmap)
"GN" = (/turf/simulated/floor/wood/yew,/area/devmap)
"Jb" = (/obj/structure/table/woodentable,/obj/item/chems/ivbag/blood/OMinus,/turf/simulated/floor/wood/yew,/area/devmap)
"JC" = (/obj/structure/rack/dark,/turf/simulated/floor/wood/yew,/area/devmap)
"JJ" = (/turf/simulated/ground/concrete/reinforced/damaged,/area/devmap)
"JN" = (/obj/structure/bed,/turf/simulated/floor/wood/yew,/area/devmap)
"JO" = (/obj/structure/table/steel,/obj/item/boombox,/turf/simulated/floor/wood/yew,/area/devmap)
"KB" = (/obj/machinery/optable,/turf/simulated/floor/wood/yew,/area/devmap)
"Lp" = (/obj/structure/bed/chair/wood{dir = 8},/turf/simulated/floor/wood/yew,/area/devmap)
"MU" = (/obj/structure/rack/dark,/obj/structure/rack/dark,/turf/simulated/floor/wood/yew,/area/devmap)
"NC" = (/obj/structure/table/steel,/obj/structure/rack/dark,/turf/simulated/floor/wood/yew,/area/devmap)
"ND" = (/obj/machinery/computer/dummy{dir = 8},/turf/simulated/floor/wood/yew,/area/devmap)
"NZ" = (/obj/structure/bed/sofa/left/beige{dir = 8},/turf/simulated/floor/wood/yew,/area/devmap)
"OI" = (/obj/structure/door/wood,/turf/simulated/floor/wood/usedup,/area/devmap)
"Ph" = (/obj/structure/flora/pottedplant/tall,/turf/simulated/ground/sand,/area/devmap)
"Px" = (/obj/structure/bed/chair/comfy/red{dir = 8},/turf/simulated/floor/wood/yew,/area/devmap)
"QE" = (/obj/structure/table/woodentable,/obj/item/storage/box/bloodpacks,/turf/simulated/floor/wood/yew,/area/devmap)
"QP" = (/obj/structure/flora/bush/grassybush,/turf/simulated/ground/sand,/area/devmap)
"UZ" = (/turf/unsimulated/wall,/area/space)
"Vh" = (/turf/simulated/ground/sand,/area/devmap)
"VK" = (/obj/structure/door/wood,/obj/structure/tape_barricade/door,/obj/structure/barricade,/turf/simulated/floor/wood/yew,/area/devmap)
"VP" = (/obj/structure/door/wood,/turf/simulated/floor/wood/yew,/area/devmap)
"XN" = (/obj/structure/closet/secure_closet/freezer/kitchen,/turf/simulated/floor/wood/yew,/area/devmap)

(1,1,1) = {"
UZUZUZUZUZUZUZUZUZUZUZUZUZUZUZUZUZUZUZUZUZUZUZUZUZUZUZUZUZUZUZUZUZUZUZUZUZUZUZUZUZUZUZUZUZUZUZUZUZUZUZUZUZUZUZUZUZUZUZUZUZUZUZUZUZUZ
UZaaaaaaaaaaaaaaaaaaaaaaaaaaaaaaaaaaaaaaaaaaaaaaVhVhVhtGtGtGtGtGtGtGVhVhVhaaaaaaaaaaaaaaaaaaaaaaaaaaaaaaaaaaaaaaaaaaaaaaaaaaaaaaaaUZ
UZaaaaaaaaaaaaaaaaaaabaaaaaaaaacaaaaaaaaaaaaaaVhVhVhtGtGtGtGtGtGVhVhVhQPVhaaadaaaaaaaaaaaaaaaaaaaaaaaaaaaaaaaaaaaaaaaaaaaaaaaaaaaaUZ
UZaaaaaaaaaaaaabaaabaaaaaaaaaaaaaaaaaaaeaaaaaaVhVhtGtGtGtGtGtGVhVhVhVhaaaaaaaaadaaaaaaaaaaaaaaaaaaaaaaaaaaaaaaaaaaaaaaaaaaaaaaaaaaUZ
UZaaaaaaafaaabaaaaaaaaaaaaaaaaaaaaaaaaadaaaaaaVhVhtGtGtGtGtGVhVhVhaaaaaaaaaaaaaaaaaaaaaaaaaaaaaaaaafaaaaaaaaaaaaaaaaaaaaaaaaaaaaaaUZ
UZaaaaaaaaaaaaaaaaabaaaaaaaeaaaaaaaaaaaaaaaaaaVhVhtGtGtGtGJJVhVhaaaaaaaaafaaaaaaaaacaaaaaaaaaaaaaaaaaaaaaaaaaaaaaaaaaaaaaaaaaaaaaaUZ
UZaaaaaaaaaaaaaaaaaaaaaaaaaeaaaaaaaaaaaaaaaaaaVhVhtGtGJJJJtGVhVhaaaaaaaaaaaaaaaaaaaaaaaaaaaaafaaaaaaaaaaaaaaaaaaaaaaaaaaaaaaaaaaaaUZ
UZaaaaaaaaaaaaaaaaaaaaaaaaacaaaaaaaaaaaaaaafaaVhVhtGtGtGtGtGVhVhaaVhVhaaaaaaVhVhaaaaaaaaafaaaaaaaaaaaaaaaaaaaaaaaaaaaaaaaaaaaaaaaaUZ
UZaaaaaaaaaaaaaaaaaaaaaaaaaaaaaaaaaaaaaaaaaaaaVhVhtGtGtGtGtGVhVhVhoXoXVhaaVhoXoXVhaaaaaaaaaaaaaaaaaaaaaaaaaaaaaaaaaaafaaaaaaaaaaaaUZ
UZaaaaaaaaaaaaaaaaaaaaaaaaaaaaaaaaaaafaaaaaaaaVhVhtGJJtGtGtGVhVhoXoXVhaeaaaaVhoXVhaaaaaaaaaaaaaaaaafaaaaaaaaaaaaaaaaaaaaaaaaaaaaaaUZ
UZaaaaaaaaaaaaaaaaaaaaaaaaaaaaaaaaaaaaaaaaaaaaVhQPtGtGJJtGtGVhcMoXVhaaaaaaaaaaVhaaaaaaaaaaaaaaaaaaaaaaaaaaaaaaaaaaaaaaaaaaaaaaaaaaUZ
UZaaaaaaaaaaaaaaaaaaaaaaaaaaaaqHivqHqHqHqHivqHVhVhtGtGJJtGtGVhVhVhafaaaaaaVhaaaaaaaaaaaaaaaaaaaaaaaaaaaaaaaaaaaaaaaaaaaaaaaaaaaaaaUZ
UZaaaaaaaaaaaaaaaaafaaaaaaaaaaqHJOfOGNJCJCJCqHVhVhtGtGJJtGtGVhVhaaaaaaaaVhoXVhaaaaaaaaaaacaaaaaaaaaaaaaaaaafaaaaaaaaaaaaaaaaaaaaaaUZ
UZaaacaaaaaaaaaaaaaaaaaaaaaaaaqHDSGNGNGNGNGNivPhVhtGtGtGJJtGVhVhaaacaaVhoXoXVhaaaaaaaaaaaaafaaaaaaaaaaaaaaaaaaaaaaaaaaaaaaaaaaaaaaUZ
UZaaaaaaaaaaaaaaaaaaaaaaqHqHqHqHGNGNNCGNJCGNVPagagtGtGtGtGtGVhQPaaaaaaVhoXoXVhaaaaaaaaaaaaaaaaaaaaaaaaaaaaaaaaaaaaaaaaaaaaaaaaaaaaUZ
UZaaaaaaafaaaaaaaaaaaaaaqHJNGNqHGNGNNCGNGNGNivVhVhtGtGtGtGtGVhVhPhaaVhoXoXVhaaaaaaaaaaaaaaaaaaaaaaaaaaaaaaaaaaaaaaaaaaaaaaaaaaaaaaUZ
UZaaaaaaafaaaaaaaaaaaaaaqHhTGNGNGNGNNCJCMUJCqHVhVhtGtGtGtGtGVhcMVhVhVhVhVhVhVhVhVhVhVhVhQPVhVhVhVhVhVhVhVhaaaaaaaaaaaaaaaaaaaaaaaaUZ
UZaaaaaaaaaaacaaaaaaaaaaqHqHqHqHivqHqHqHqHivqHVhcMtGtGtGtGtGVhVhVhQPVhVhVhVhVhVhVhVhVhVhVhVhVhVhVhVhVhVhVhaaaaaaaaaaaaaaaaafaaaaaaUZ
UZaaaaaaaaaaaaaaaaaaaaaaaaaaVhVhaaaaaaVhVhVhVhtGtGtGtGtGtGtGtGtGtGtGtGtGtGtGtGtGtGtGtGtGtGtGtGtGtGtGtGtGtGaaaaaaaaaaaaaaaaaaaaaaaaUZ
UZaaaaaaaaaaaaaaaaaaaaaaaaVhoXoXPhVhVhVhVhtGtGtGtGtGtGtGtGtGtGtGtGtGtGtGtGtGtGtGtGtGtGtGtGtGJJtGtGtGtGtGtGaaaaaaaaaaaaaaaaaaaaaaaaUZ
UZaaaaaaaaaaaaaaaaaaaaaaVhoXVhQPVhVhVhVhtGtGtGtGtGtGtGtGtGtGtGJJtGtGtGtGtGtGtGtGtGtGtGtGtGtGtGJJtGtGtGtGtGaaaaaaaaaaaaaaaaaaaaaaaaUZ
UZaaaaaaaaaaaaaaaaafaaaaaaVhVhVhVhVhtGtGtGtGtGtGtGtGtGtGtGtGtGtGtGtGtGtGtGtGtGtGtGtGtGtGtGtGtGtGtGtGtGtGtGaaaaaaaaaaaaaaaaaaaaaaaaUZ
UZaaaaaaaaaaaaaaaaaaaaVhVhVhVhVhtGtGtGtGtGtGtGtGtGtGtGtGtGtGtGtGtGtGtGtGtGtGtGtGtGtGtGtGtGtGtGtGtGtGtGtGtGaaaaaaaaaaaaaaaaaaaaaaaaUZ
UZaaafaaaaaaaaaaaaaaVhVhVhVhVhtGtGtGtGJJtGtGtGtGtGtGVhVhVhVhVhVhVhVhVhVhVhVhVhVhVhVhVhVhVhVhVhVhVhVhVhVhVhaaaaaaaaaaaaaaaaaaaaaaaaUZ
UZaaaaaaaaadaaaaaaVhVhVhVhtGtGtGtGtGtGJJtGtGtGtGVhVhVhVhQPVhVhPhVhVhVhVhVhVhVhVhVhVhVhVhVhVhVhVhVhVhVhVhVhaaaaaaaaaaaaaaaaaaaaaaaaUZ
UZaaaaaaaaaaaaVhVhVhVhtGtGtGtGtGtGtGtGtGJJtGVhVhVhVhVhVhaaaaaaaaVhVhaaaaaaaaaaaaaaaaaeaaaaaaaaaaaaaaaaaaaaaaaaaaaaaaaaaaaaaaaaaaaaUZ
UZaaacaaaaaaVhVhVhVhtGtGtGtGtGtGtGtGtGtGtGVhVhVhcMVhaaaaaaacaaaaaaoXVhVhaaaaaaaaaaaaaaaaaaaaaaaaaaaaaaaaaaaaaaaaaaaaaaaaaaaaaaaaaaUZ
UZaaaaaaaaVhVhVhtGtGtGtGtGtGtGtGtGtGtGVhVhVhVhVhaaaaaaaaaaaaaaaaaaVhoXoXVhaaaaaaaaaaaaaaaaaaaaaaafaaaaaaaaaaaaaaaaaaaaaaaaaaaaaaaaUZ
UZaaaaVhVhVhVhtGtGtGtGtGtGtGtGtGtGtGVhVhVhVhaaaaaaaaaaaaaaaaaaaaaaVhoXoXoXVhafaaaaaaaaaaaaaaaaaaaaaaaaaaaaaaaaaaaaaaaaaaaaaaaaaaaaUZ
UZaaaaaaVhtGtGtGtGJJtGtGtGJJtGtGVhVhVhVhVhaeaaaaaaaaaaaaaaaaaaaaaaaaVhoXoXoXVhaaaaaaafaaaaaaaaaaaaaaaaaaaaaaaaaaaaaaaaaaaaaaaaaaaaUZ
UZaaaaaatGtGtGtGtGtGtGtGtGtGtGVhVhVhVhadaaaaaaaaaaaaaaaaahaaafaaaaaaaaVhoXoXoXVhaaaaaaaaaaaaaaaaaaaaaaaaaaaaaaaaaaaaaaaaaaaaaaaaaaUZ
UZaaaaaatGtGtGtGtGtGtGtGtGtGVhVhVhQPaaaaaaaaaaaiaiaiDTaiaiaiaaaaaaaaaaaaVhoXoXoXVhaaaaaaaaaaaaaaaaaaaaaaaaaaaaaaaaafaaaaaaaaaaaaaaUZ
UZaaaaaaaatGtGtGJJtGtGtGtGVhVhVhaaaaqHqHivivqHqHDTDTDTDTDTqHqHivivqHqHaaaaVhoXoXVhaaaaaaaaaaaaaaacaaaaaaaaaaaaaaaaaaaaaaaaaaaaaaaaUZ
UZaaaaaaaatGtGJJtGtGtGtGVhVhVhafaaaaqHJNiHecJbqHDTqHOIqHDTqHJCJNJNJCqHaaaaVhoXoXVhaaafaaaaaaaaaeaaaaaaaaaaaaaaaaaaaaaaaaaaaaaaaaaaUZ
UZaaaaaaaatGtGtGtGtGVhVhVhVhaaaaaaaaqHGNLpGNQElHlHqHGNqHqHqHGNGNGNGNqHaaaaVhoXoXoXVhaaaaaaaaaaaaaaaaaaaaaaaaaaaaaaaaaaaaaaaaaaaaaaUZ
UZaaaaaaaatGtGtGVhVhVhVhVhaaaaacaaaaqHizAXGNGNGNGNGNGNGNqHqHrAGNGNGNqHaaaaVhoXoXoXVhaaaaaaaaaaaaaaaaaaaaaaaaaaaaaaaaaaaaaaaaaaaaaaUZ
UZaaaaaaaatGVhVhVhVhVhaaaaaaaaaaaaaaivBHGNlpKBGNNDqHBpGNqHqHbSGNGNhFqHaaaaVhoXoXoXVhaaaaaaaaaaaaaaaaaaaaaaaaaaaaaaaaaaaaaaaaaaaaaaUZ
UZaaaaaaaaVhVhVhVhaaaaaaaaaaafaaaaaaqHrAGNGNiHGNGNqHJCGNqHqHGNGNqHDrqHqHaaVhoXoXoXVhaaaaaaaaaaaaaaaaaaaaaaaaaaaaaaaaaaaaaaaaaaaaaaUZ
UZaaaaaaaaVhaaaaaaaaaaaaaaaaaaaaaaaaqHqHqHqHqHGNqHqHGNGNqHqHGNGNqHltmJqHaaaaVhoXoXVhaaaaaaaaaaaaaaaaaaaaaaaaaaaaaaaaaaaaaaaaaaaaaaUZ
UZaaaaaaaaaaaaaaaaaaaaaaaaaaaaaaaaaaaaaaaaqHBLGNGNqHGNGNqHqHqHGNqHVPqHqHaaaaaaVhoXVhaaaaaaaaaaaaaaaaaaaaaaaaaaaaaaaaaaaaaaaaaaaaaaUZ
UZaaaaaaaaaaaaaaadaaaaaaaaacaaaaaaaaaaaaaaqHGNGNNZqHGNGNGNGNGNGNGNGNGNqHaaaaaaaaVhaaaaaaaaaaaaaaaaaaaaaaaaaaaaaaaaaaaaaaaaaaaaaaaaUZ
UZaaaaafaaaaaaaaaaaaaaaaaaaaaaaaaaaaaaaaaalHbSGNCTGNGNqHlHlHqHqHqHGNqHqHaaaaaaafaaaaaaaaaaaaaaaaaaaaaaaaaaaaaaaaaaaaaaaaaaaaaaaaaaUZ
UZaaaaaaaaaaaaaaaaaaaeaaaaaaaaaaaaafaaaaaaqHGNGNGNGNGNqHaaqHGNGNGNGNGNqHaaaaaaaaaaaaaaaaaaaaaaaaaaaaaaaaaaaaaaaaaaaaaaaaaaaaaaaaaaUZ
UZaaaaaaaaaaaaaaaaaaaaaaaaaaaaaaaaaaaaaaaaqHbSrAPxJCGNqHaaqHDSGNcqrALpqHaaaaaaaaaaaaaaaaaaaaaaafaaaaaaaaaaaaaaaaaaaaaaaaaaaaaaaaaaUZ
UZVhVhaaaaaaaaaaaaaaaaaaaaaaaaaaaaaaaaaaaaqHqHivivivVKqHaaqHfrGNGNGNGNqHaaaaaaaaaaaaaaaaaaaaaaaaafaaaaaaaaaaaaaaaaaaaaaaaaaaaaaaaaUZ
UZVhVhVhaaaaaaaaaaaaaaaaaaaaaaaaaaaaaaaaaaaiaaaaaaaaaaaaaaqHXNDStIDSGNqHaaaaaaaaaaaaaaaaaaaaaaaaaaaaaaaaaaaaaaaaaaaaaaaaaaaaaaaaaaUZ
UZoXVhVhVhaaaaaaaaaaaaaaaaaaaaaaaaaaaaaaaaaiaaajaaaaaaaaaaqHqHqHivivqHqHaaaaaaaaaaaaaaaaaeaaaaaaaaaaaaaaaaaaaaaaaaaaaaaaaaaaaaaaaaUZ
UZoXoXVhVhVhaaaaaaaaaaaaaaaaaaaaaaafaaaaaaaiaaaaakaaafaaaaaaaaaaaaaaafaiaaaaaaaaaaaaaaaaaeaaaaaaaaaaaaaaaaaaaaaaaaaaaaaaaaaaaaaaaaUZ
UZoXoXoXVhVhVhaaaaaaaaaaaaaaaaaaaaaaaaaaaaaiaaalaaaaaaaaaaadaaaaamaaaaaiaaaaaaaaaaaaaaaaaaaaaaaaaaaaaaaaaaaaafafaaaaaaaaaaaaaaaaaaUZ
UZoXoXoXoXVhVhVhaaaaaaaaaaaaaaaaaaaaaaaaaaaiaaaaaaaaaaaaaaaaaaaaaaamaaaiaaaaaaaaaaaaaaaaaaaaaaaaaaaaaaaaaaaaaaaaaaaaaaaaaaaaaaaaaaUZ
UZoXoXoXoXoXVhVhaaaaaaaaaaaaaeaaaaaaaaaaaaaiaiaiaiaiaiaaaaaiaiaiaiaiaiaiaaaaaaaaaaaaaaaaaaaaaaaaaaaaaaaaaaaaaaaaaaaaaaaaaaaaaaaaaaUZ
UZoXoXoXoXoXoXVhVhaaaaaaaaaaaaVhVhVhVhVhaaaaaaaaaaaaaaaaaaaaaaaaaaaaaaaaaaaaaaaaaaaaaaaaaaaaaaaaaaaaaaaaaaaaaaaaaaaaaaaaaaaaaaaaaaUZ
UZoXoXoXoXoXoXVhVhVhaaaaaaVhVhVhVhVhVhVhVhVhVhVhVhVhaaVhVhVhVhaaaaaaaaaaaaaaaaaaaaaaaaaaaaaaaaaaaaaaaaaaaaaaaaaaaaaaaaaaaaaaaaaaaaUZ
UZoXoXoXoXoXoXoXVhVhVhaaVhVhVhoXoXoXoXoXVhVhoXoXoXoXpiVhVhVhVhVhVhVhVhcMaaaaaaaaaaaaaaaaaaaaaaaaaaaaaaaaaaaaaaaaaaaaaaaaaaaaaaaaaaUZ
UZoXoXoXoXoXoXoXoXVhVhcMVhoXoXoXoXoXoXoXoXoXoXoXpipipioXoXoXoXoXoXVhVhVhVhVhVhVhVhVhVhVhaaaaaaaaaaaaaaaaaaaaaaaaaaaaaaaaaaaaaaaaVhUZ
UZoXoXoXoXoXoXoXoXVhVhVhVhoXoXoXoXoXoXoXoXoXoXpipioXoXoXoXoXoXoXoXoXoXoXoXoXoXoXoXoXVhVhVhVhaaaaaaaaafaaaaaaaaaaaaaaaaaaaaaaaaVhVhUZ
UZoXoXoXoXoXanoXoXoXoXoXoXoXoXoXoXoXoXoXoXpipipipipipioXoXoXoXoXoXoXoXoXoXoXoXoXoXoXoXoXVhVhVhVhaaaaaaaaaaaaaaaaaaaaaaaaaaaaVhVhoXUZ
UZoXoXoXoXoXoXoXoXoXoXoXoXoXoXoXoXoXoXoXoXoXoXoXoXpipioXoXoXoXoXoXoXoXoXoXoXoXoXoXoXoXoXoXoXVhVhVhVhaaaaaaaaaaaaaaaaVhVhVhVhVhoXoXUZ
UZoXoXoXoXoXoXoXoXoXoXoXoXoXoXoXoXoXoXoXpioXoXoXoXoXpioXoXoXoXoXoXoXoXoXoXoXoXoXoXoXoXoXoXoXoXoXVhVhVhVhVhaaaaaaVhVhVhVhVhoXoXoXoXUZ
UZoXoXoXoXoXoXoXoXoXoXoXpipioXoXoXoXpipipipipipipioXpipioXoXoXoXpipipipioXoXoXoXoXoXoXoXoXoXoXoXoXoXoXoXVhVhaaVhVhoXoXoXoXoXoXoXoXUZ
UZoXoXoXoXoXoXoXoXoXoXoXpipipipioXoXoXpioXoXoXpipioXoXpipioXoXpipipipipipioXoXoXoXoXoXoXoXoXoXoXoXoXoXoXoXoXpioXoXoXoXoXoXoXoXoXoXUZ
UZoXoXoXoXoXoXoXoXoXoXoXpipipipipipipipioXoXoXoXpioXoXpipipipipipipipipipioXoXoXoXoXoXoXoXoXoXoXoXoXoXoXpipipipioXoXoXoXoXoXoXoXoXUZ
UZoXoXoXoXoXoXoXoXoXoXoXoXpipipipipioXoXoXoXoXpipipipipioXoXoXoXpipipipipioXoXoXoXoXoXoXoXoXoXoXoXoXoXpipioXoXpioXoXoXoXoXoXoXoXoXUZ
UZoXoXoXoXoXoXoXoXoXoXoXoXoXpipioXoXoXoXoXoXoXoXoXoXoXoXoXoXoXoXoXoXpipioXoXoXoXoXoXoXoXoXoXoXoXoXoXoXoXoXoXoXoXoXoXoXoXoXoXoXoXoXUZ
UZoXoXoXoXoXoXoXoXoXoXoXoXoXoXoXoXoXoXoXoXoXoXoXoXoXoXoXoXoXoXoXoXoXoXoXoXoXoXoXoXoXoXoXoXoXoXoXoXoXoXoXoXoXoXoXoXoXoXoXoXoXoXoXoXUZ
UZUZUZUZUZUZUZUZUZUZUZUZUZUZUZUZUZUZUZUZUZUZUZUZUZUZUZUZUZUZUZUZUZUZUZUZUZUZUZUZUZUZUZUZUZUZUZUZUZUZUZUZUZUZUZUZUZUZUZUZUZUZUZUZUZUZ
"}
