"an" = (/obj/structure/bed/sofa/left/beige{dir = 8},/turf/simulated/floor/wood/yew,/area/space)
"bB" = (/obj/structure/flora/pottedplant/shoot,/turf/exterior/dry,/area/space)
"bD" = (/obj/structure/gravemarker,/turf/exterior/dry,/area/space)
"bS" = (/obj/machinery/computer/dummy{dir = 8},/turf/simulated/floor/wood/yew,/area/space)
"cq" = (/obj/structure/flora/pottedplant/smalltree,/turf/exterior/dry,/area/space)
"cM" = (/obj/structure/flora/pottedplant/tall,/turf/exterior/sand,/area/space)
"ec" = (/obj/machinery/optable,/turf/simulated/floor/wood/yew,/area/space)
"es" = (/obj/structure/table/steel,/obj/structure/rack/dark,/turf/simulated/floor/wood/yew,/area/space)
"fr" = (/obj/structure/flora/bush/grassybush,/turf/exterior/dry,/area/space)
"fO" = (/obj/structure/table/woodentable,/turf/simulated/floor/wood/yew,/area/space)
"hF" = (/turf/simulated/wall/wood,/area/space)
"hT" = (/turf/exterior/concrete/reinforced/damaged,/area/space)
"iv" = (/obj/structure/bed/chair/comfy/red{dir = 8},/turf/simulated/floor/wood/yew,/area/space)
"iz" = (/obj/structure/bed/chair/wood{dir = 8},/turf/simulated/floor/wood/yew,/area/space)
"iH" = (/obj/structure/rack/dark,/turf/simulated/wall/wood,/area/space)
"lp" = (/obj/structure/table/woodentable,/obj/item/chems/ivbag/blood/OMinus,/turf/simulated/floor/wood/yew,/area/space)
"lt" = (/obj/structure/hygiene/sink,/obj/structure/hygiene/sink,/obj/structure/table/steel,/turf/simulated/floor/wood/yew,/area/space)
"lH" = (/obj/structure/hygiene/shower{dir = 4},/turf/simulated/floor/wood/yew,/area/space)
"mJ" = (/obj/structure/table/woodentable,/obj/item/modular_computer/laptop,/turf/simulated/floor/wood/yew,/area/space)
"or" = (/obj/structure/door/wood,/turf/simulated/floor/wood/usedup,/area/space)
"oX" = (/turf/exterior/dirt,/area/space)
"pi" = (/turf/unsimulated/mineral,/area/space)
"qH" = (/obj/structure/bed,/turf/simulated/floor/wood/yew,/area/space)
"qM" = (/obj/structure/hygiene/sink{dir = 1},/turf/simulated/wall/wood,/area/space)
"rA" = (/obj/structure/curtain/medical,/turf/simulated/floor/wood/yew,/area/space)
"tG" = (/obj/structure/flora/bush/sparsegrass,/turf/exterior/sand,/area/space)
"tI" = (/obj/structure/closet/secure_closet/freezer/kitchen,/turf/simulated/floor/wood/yew,/area/space)
"vk" = (/obj/structure/table/steel,/turf/simulated/floor/wood/yew,/area/space)
"xk" = (/obj/structure/bookcase,/turf/simulated/floor/wood/yew,/area/space)
"AX" = (/obj/structure/table/steel,/obj/machinery/microwave,/turf/simulated/floor/wood/yew,/area/space)
"Bp" = (/obj/structure/closet/secure_closet/freezer/fridge,/turf/simulated/floor/wood/yew,/area/space)
"BH" = (/obj/structure/curtain/medical,/obj/structure/curtain/medical,/turf/simulated/floor/wood/yew,/area/space)
"BL" = (/obj/structure/rack/dark,/obj/structure/rack/dark,/turf/simulated/floor/wood/yew,/area/space)
"Dr" = (/obj/structure/iv_drip,/turf/simulated/floor/wood/yew,/area/space)
"Dz" = (/obj/structure/door/wood,/turf/simulated/floor/wood/yew,/area/space)
"DS" = (/obj/structure/bed/chair{dir = 8},/turf/simulated/floor/wood/yew,/area/space)
"DT" = (/obj/structure/barricade,/turf/exterior/dry,/area/space)
"GN" = (/obj/structure/bed/chair/wood{dir = 4},/turf/simulated/floor/wood/yew,/area/space)
"HE" = (/obj/structure/flora/pottedplant/tall,/turf/exterior/dry,/area/space)
"Jb" = (/obj/structure/coatrack,/turf/simulated/floor/wood/yew,/area/space)
"JC" = (/obj/item/stack/flag/blue,/turf/exterior/dry,/area/space)
"JJ" = (/turf/exterior/concrete/reinforced/road,/area/space)
"JN" = (/obj/structure/window/basic/full,/turf/exterior/dirt,/area/space)
"JO" = (/obj/structure/door/wood,/obj/structure/tape_barricade/door,/obj/structure/barricade,/turf/simulated/floor/wood/yew,/area/space)
"KB" = (/obj/structure/bed/sofa/right/beige{dir = 8},/turf/simulated/floor/wood/yew,/area/space)
"KE" = (/obj/structure/flora/stump/tree/dead,/turf/exterior/dry,/area/space)
"Lp" = (/obj/structure/bed/roller,/turf/simulated/floor/wood/yew,/area/space)
"MU" = (/obj/structure/bed/chair/comfy/red{dir = 4},/turf/simulated/floor/wood/yew,/area/space)
"NC" = (/turf/simulated/floor/wood/yew,/area/space)
"ND" = (/obj/structure/table/woodentable,/obj/item/storage/box/bloodpacks,/turf/simulated/floor/wood/yew,/area/space)
"NZ" = (/obj/structure/table/steel,/obj/item/boombox,/turf/simulated/floor/wood/yew,/area/space)
"OI" = (/turf/simulated/floor/wood/usedup,/area/space)
"Ph" = (/turf/exterior/sand,/area/space)
"Px" = (/obj/structure/gravemarker,/turf/unsimulated/mineral,/area/space)
"QE" = (/obj/structure/flora/plant,/turf/exterior/dry,/area/space)
"QP" = (/obj/structure/closet/wardrobe,/turf/simulated/floor/wood/yew,/area/space)
"UZ" = (/turf/exterior/dry,/area/space)
"Vh" = (/obj/structure/flora/bush/grassybush,/turf/exterior/sand,/area/space)
"VK" = (/obj/item/chems/ivbag/blood/OMinus,/obj/structure/table,/obj/item/storage/firstaid/surgery/ghetto,/turf/simulated/floor/wood/yew,/area/space)
"VP" = (/obj/structure/hygiene/toilet{dir = 8},/turf/simulated/floor/wood/yew,/area/space)
"XN" = (/obj/structure/rack/dark,/turf/simulated/floor/wood/yew,/area/space)
"XU" = (/obj/effect/overlay/palmtree_l,/turf/exterior/dry,/area/space)
"YG" = (/obj/structure/flora/bush/sparsegrass,/turf/exterior/dry,/area/space)

(1,1,1) = {"
UZUZUZUZUZUZUZUZUZUZUZUZUZUZUZUZUZUZUZUZUZUZUZPhPhPhJJJJJJJJJJJJJJPhPhPhUZUZUZUZUZUZUZUZUZUZUZUZUZUZUZUZUZUZUZUZUZUZUZUZUZUZUZUZ
UZUZUZUZUZUZUZUZUZbDUZUZUZUZKEUZUZUZUZUZUZUZPhPhPhJJJJJJJJJJJJPhPhPhVhPhUZHEUZUZUZUZUZUZUZUZUZUZUZUZUZUZUZUZUZUZUZUZUZUZUZUZUZUZ
UZUZUZUZUZUZbDUZbDUZUZUZUZUZUZUZUZUZfrUZUZUZPhPhJJJJJJJJJJJJPhPhPhPhUZUZUZUZHEUZUZUZUZUZUZUZUZUZUZUZUZUZUZUZUZUZUZUZUZUZUZUZUZUZ
UZUZUZYGUZbDUZUZUZUZUZUZUZUZUZUZUZUZHEUZUZUZPhPhJJJJJJJJJJPhPhPhUZUZUZUZUZUZUZUZUZUZUZUZUZUZUZUZYGUZUZUZUZUZUZUZUZUZUZUZUZUZUZUZ
UZUZUZUZUZUZUZUZbDUZUZUZfrUZUZUZUZUZUZUZUZUZPhPhJJJJJJJJhTPhPhUZUZUZUZYGUZUZUZUZKEUZUZUZUZUZUZUZUZUZUZUZUZUZUZUZUZUZUZUZUZUZUZUZ
UZUZUZUZUZUZUZUZUZUZUZUZfrUZUZUZUZUZUZUZUZUZPhPhJJJJhThTJJPhPhUZUZUZUZUZUZUZUZUZUZUZUZUZUZYGUZUZUZUZUZUZUZUZUZUZUZUZUZUZUZUZUZUZ
UZUZUZUZUZUZUZUZUZUZUZUZKEUZUZUZUZUZUZUZYGUZPhPhJJJJJJJJJJPhPhUZPhPhUZUZUZPhPhUZUZUZUZYGUZUZUZUZUZUZUZUZUZUZUZUZUZUZUZUZUZUZUZUZ
UZUZUZUZUZUZUZUZUZUZUZUZUZUZUZUZUZUZUZUZUZUZPhPhJJJJJJJJJJPhPhPhpipiPhUZPhpipiPhUZUZUZUZUZUZUZUZUZUZUZUZUZUZUZUZUZYGUZUZUZUZUZUZ
UZUZUZUZUZUZUZUZUZUZUZUZUZUZUZUZUZYGUZUZUZUZPhPhJJhTJJJJJJPhPhpipiPhfrUZUZPhpiPhUZUZUZUZUZUZUZUZYGUZUZUZUZUZUZUZUZUZUZUZUZUZUZUZ
UZUZUZUZUZUZUZUZUZUZUZUZUZUZUZUZUZUZUZUZUZUZPhVhJJJJhTJJJJPhtGpiPhUZUZUZUZUZPhUZUZUZUZUZUZUZUZUZUZUZUZUZUZUZUZUZUZUZUZUZUZUZUZUZ
UZUZUZUZUZUZUZUZUZUZUZUZUZUZhFJNhFhFhFhFJNhFPhPhJJJJhTJJJJPhPhPhYGUZUZUZPhUZUZUZUZUZUZUZUZUZUZUZUZUZUZUZUZUZUZUZUZUZUZUZUZUZUZUZ
UZUZUZUZUZUZUZUZYGUZUZUZUZUZhFNZDSNCXNXNXNhFPhPhJJJJhTJJJJPhPhUZUZUZUZPhpiPhUZUZUZUZUZKEUZUZUZUZUZUZUZUZYGUZUZUZUZUZUZUZUZUZUZUZ
UZKEUZUZUZUZUZUZUZUZUZUZUZUZhFvkNCNCNCNCNCJNcMPhJJJJJJhTJJPhPhUZKEUZPhpipiPhUZUZUZUZUZUZYGUZUZUZUZUZUZUZUZUZUZUZUZUZUZUZUZUZUZUZ
UZUZUZUZUZUZUZUZUZUZUZhFhFhFhFNCNCesNCXNNCDzUZUZJJJJJJJJJJPhVhUZUZUZPhpipiPhUZUZUZUZUZUZUZUZUZUZUZUZUZUZUZUZUZUZUZUZUZUZUZUZUZUZ
UZUZUZYGUZUZUZUZUZUZUZhFqHNChFNCNCesNCNCNCJNPhPhJJJJJJJJJJPhPhcMUZPhpipiPhUZUZUZUZUZUZUZUZUZUZUZUZUZUZUZUZUZUZUZUZUZUZUZUZUZUZUZ
UZUZUZYGUZUZUZUZUZUZUZhFBpNCNCNCNCesXNBLXNhFPhPhJJJJJJJJJJPhtGPhPhPhPhPhPhPhPhPhPhPhPhVhPhPhPhPhPhPhPhPhUZUZUZUZUZUZUZUZUZUZUZUZ
UZUZUZUZUZKEUZUZUZUZUZhFhFhFhFJNhFhFhFhFJNhFPhtGJJJJJJJJJJPhPhPhVhPhPhPhPhPhPhPhPhPhPhPhPhPhPhPhPhPhPhPhUZUZUZUZUZUZUZUZYGUZUZUZ
UZUZUZUZUZUZUZUZUZUZUZUZUZPhPhUZUZUZPhPhPhPhJJJJJJJJJJJJJJJJJJJJJJJJJJJJJJJJJJJJJJJJJJJJJJJJJJJJJJJJJJJJUZUZUZUZUZUZUZUZUZUZUZUZ
UZUZUZUZUZUZUZUZUZUZUZUZPhpipicMPhPhPhPhJJJJJJJJJJJJJJJJJJJJJJJJJJJJJJJJJJJJJJJJJJJJJJJJJJhTJJJJJJJJJJJJUZUZUZUZUZUZUZUZUZUZUZUZ
UZUZUZUZUZUZUZUZUZUZUZPhpiPhVhPhPhPhPhJJJJJJJJJJJJJJJJJJJJJJhTJJJJJJJJJJJJJJJJJJJJJJJJJJJJJJhTJJJJJJJJJJUZUZUZUZUZUZUZUZUZUZUZUZ
UZUZUZUZUZUZUZUZYGUZUZUZPhPhPhPhPhJJJJJJJJJJJJJJJJJJJJJJJJJJJJJJJJJJJJJJJJJJJJJJJJJJJJJJJJJJJJJJJJJJJJJJUZUZUZUZUZUZUZUZUZUZUZUZ
UZUZUZUZUZUZUZUZUZUZPhPhPhPhPhJJJJJJJJJJJJJJJJJJJJJJJJJJJJJJJJJJJJJJJJJJJJJJJJJJJJJJJJJJJJJJJJJJJJJJJJJJUZUZUZUZUZUZUZUZUZUZUZUZ
UZYGUZUZUZUZUZUZUZPhPhPhPhPhJJJJJJJJhTJJJJJJJJJJJJPhPhPhPhPhPhPhPhPhPhPhPhPhPhPhPhPhPhPhPhPhPhPhPhPhPhPhUZUZUZUZUZUZUZUZUZUZUZUZ
UZUZUZUZHEUZUZUZPhPhPhPhJJJJJJJJJJJJhTJJJJJJJJPhPhPhPhVhPhPhcMPhPhPhPhPhPhPhPhPhPhPhPhPhPhPhPhPhPhPhPhPhUZUZUZUZUZUZUZUZUZUZUZUZ
UZUZUZUZUZUZPhPhPhPhJJJJJJJJJJJJJJJJJJhTJJPhPhPhPhPhPhUZUZUZUZPhPhUZUZUZUZUZUZUZUZfrUZUZUZUZUZUZUZUZUZUZUZUZUZUZUZUZUZUZUZUZUZUZ
UZKEUZUZUZPhPhPhPhJJJJJJJJJJJJJJJJJJJJJJPhPhPhtGPhUZUZUZKEUZUZUZpiPhPhUZUZUZUZUZUZUZUZUZUZUZUZUZUZUZUZUZUZUZUZUZUZUZUZUZUZUZUZUZ
UZUZUZUZPhPhPhJJJJJJJJJJJJJJJJJJJJJJPhPhPhPhPhUZUZUZUZUZUZUZUZUZPhpipiPhUZUZUZUZUZUZUZUZUZUZUZYGUZUZUZUZUZUZUZUZUZUZUZUZUZUZUZUZ
UZUZPhPhPhPhJJJJJJJJJJJJJJJJJJJJJJPhPhPhPhUZUZUZUZUZUZUZUZUZUZUZPhpipipiPhYGUZUZUZUZUZUZUZUZUZUZUZUZUZUZUZUZUZUZUZUZUZUZUZUZUZUZ
UZUZUZPhJJJJJJJJhTJJJJJJhTJJJJPhPhPhPhPhfrUZUZUZUZUZUZUZUZUZUZUZUZPhpipipiPhUZUZUZYGUZUZUZUZUZUZUZUZUZUZUZUZUZUZUZUZUZUZUZUZUZUZ
UZUZUZJJJJJJJJJJJJJJJJJJJJJJPhPhPhPhHEUZUZUZUZUZUZUZUZJCUZYGUZUZUZUZPhpipipiPhUZUZUZUZUZUZUZUZUZUZUZUZUZUZUZUZUZUZUZUZUZUZUZUZUZ
UZUZUZJJJJJJJJJJJJJJJJJJJJPhPhPhVhUZUZUZUZUZDTDTDTOIDTDTDTUZUZUZUZUZUZPhpipipiPhUZUZUZUZUZUZUZUZUZUZUZUZUZUZUZUZYGUZUZUZUZUZUZUZ
UZUZUZUZJJJJJJhTJJJJJJJJPhPhPhUZUZhFhFJNJNhFhFOIOIOIOIOIhFhFJNJNhFhFUZUZPhpipiPhUZUZUZUZUZUZUZKEUZUZUZUZUZUZUZUZUZUZUZUZUZUZUZUZ
UZUZUZUZJJJJhTJJJJJJJJPhPhPhYGUZUZhFqHDrLplphFOIhForhFOIhFXNqHqHXNhFUZUZPhpipiPhUZYGUZUZUZUZfrUZUZUZUZUZUZUZUZUZUZUZUZUZUZUZUZUZ
UZUZUZUZJJJJJJJJJJPhPhPhPhUZUZUZUZhFNCizNCNDiHiHhFNChFhFhFNCNCNCNChFUZUZPhpipipiPhUZUZUZUZUZUZUZUZUZUZUZUZUZUZUZUZUZUZUZUZUZUZUZ
UZUZUZUZJJJJJJPhPhPhPhPhUZUZKEUZUZhFrABHNCNCNCNCNCNCNChFhFfONCNCNChFUZUZPhpipipiPhUZUZUZUZUZUZUZUZUZUZUZUZUZUZUZUZUZUZUZUZUZUZUZ
UZUZUZUZJJPhPhPhPhPhUZUZUZUZUZUZUZJNmJNCVKecNCbShFJbNChFhFMUNCNCQPhFUZUZPhpipipiPhUZUZUZUZUZUZUZUZUZUZUZUZUZUZUZUZUZUZUZUZUZUZUZ
UZUZUZUZPhPhPhPhUZUZUZUZUZYGUZUZUZhFfONCNCDrNCNChFXNNChFhFNCNChFqMhFhFUZPhpipipiPhUZUZUZUZUZUZUZUZUZUZUZUZUZUZUZUZUZUZUZUZUZUZUZ
UZUZUZUZPhUZUZUZUZUZUZUZUZUZUZUZUZhFhFhFhFhFNChFhFNCNChFhFNCNChFlHVPhFUZUZPhpipiPhUZUZUZUZUZUZUZUZUZUZUZUZUZUZUZUZUZUZUZUZUZUZUZ
UZUZUZUZUZUZUZUZUZUZUZUZUZUZUZUZUZUZUZUZhFxkNCNChFNCNChFhFhFNChFDzhFhFUZUZUZPhpiPhUZUZUZUZUZUZUZUZUZUZUZUZUZUZUZUZUZUZUZUZUZUZUZ
UZUZUZUZUZUZUZHEUZUZUZUZKEUZUZUZUZUZUZUZhFNCNCanhFNCNCNCNCNCNCNCNCNChFUZUZUZUZPhUZUZUZUZUZUZUZUZUZUZUZUZUZUZUZUZUZUZUZUZUZUZUZUZ
UZUZYGUZUZUZUZUZUZUZUZUZUZUZUZUZUZUZUZUZiHMUNCKBNCNChFiHiHhFhFhFNChFhFUZUZUZYGUZUZUZUZUZUZUZUZUZUZUZUZUZUZUZUZUZUZUZUZUZUZUZUZUZ
UZUZUZUZUZUZUZUZUZfrUZUZUZUZUZUZYGUZUZUZhFNCNCNCNCNChFUZhFNCNCNCNCNChFUZUZUZUZUZUZUZUZUZUZUZUZUZUZUZUZUZUZUZUZUZUZUZUZUZUZUZUZUZ
UZUZUZUZUZUZUZUZUZUZUZUZUZUZUZUZUZUZUZUZhFMUfOivXNNChFUZhFvkNCGNfOizhFUZUZUZUZUZUZUZUZUZUZUZYGUZUZUZUZUZUZUZUZUZUZUZUZUZUZUZUZUZ
PhPhUZUZUZUZUZUZUZUZUZUZUZUZUZUZUZUZUZUZhFhFJNJNJNJOhFUZhFAXNCNCNCNChFUZUZUZUZUZUZUZUZUZUZUZUZYGUZUZUZUZUZUZUZUZUZUZUZUZUZUZUZUZ
PhPhPhUZUZUZUZUZUZUZUZUZUZUZUZUZUZUZUZUZDTUZUZUZUZUZUZUZhFtIvkltvkNChFUZUZUZUZUZUZUZUZUZUZUZUZUZUZUZUZUZUZUZUZUZUZUZUZUZUZUZUZUZ
piPhPhPhUZUZUZUZUZUZUZUZUZUZUZUZUZUZUZUZDTUZQEUZUZUZUZUZhFhFhFJNJNhFhFUZUZUZUZUZUZUZUZfrUZUZUZUZUZUZUZUZUZUZUZUZUZUZUZUZUZUZUZUZ
pipiPhPhPhUZUZUZUZUZUZUZUZUZUZUZYGUZUZUZDTUZUZbBUZYGUZUZUZUZUZUZUZYGDTUZUZUZUZUZUZUZUZfrUZUZUZUZUZUZUZUZUZUZUZUZUZUZUZUZUZUZUZUZ
pipipiPhPhPhUZUZUZUZUZUZUZUZUZUZUZUZUZUZDTUZcqUZUZUZUZUZHEUZUZXUUZUZDTUZUZUZUZUZUZUZUZUZUZUZUZUZUZUZUZUZUZYGYGUZUZUZUZUZUZUZUZUZ
pipipipiPhPhPhUZUZUZUZUZUZUZUZUZUZUZUZUZDTUZUZUZUZUZUZUZUZUZUZUZXUUZDTUZUZUZUZUZUZUZUZUZUZUZUZUZUZUZUZUZUZUZUZUZUZUZUZUZUZUZUZUZ
pipipipipiPhPhUZUZUZUZUZUZfrUZUZUZUZUZUZDTDTDTDTDTDTUZUZDTDTDTDTDTDTDTUZUZUZUZUZUZUZUZUZUZUZUZUZUZUZUZUZUZUZUZUZUZUZUZUZUZUZUZUZ
pipipipipipiPhPhUZUZUZUZUZUZPhPhPhPhPhUZUZUZUZUZUZUZUZUZUZUZUZUZUZUZUZUZUZUZUZUZUZUZUZUZUZUZUZUZUZUZUZUZUZUZUZUZUZUZUZUZUZUZUZUZ
pipipipipipiPhPhPhUZUZUZPhPhPhPhPhPhPhPhPhPhPhPhPhUZPhPhPhPhUZUZUZUZUZUZUZUZUZUZUZUZUZUZUZUZUZUZUZUZUZUZUZUZUZUZUZUZUZUZUZUZUZUZ
pipipipipipipiPhPhPhUZPhPhPhpipipipipiPhPhpipipipioXPhPhPhPhPhPhPhPhtGUZUZUZUZUZUZUZUZUZUZUZUZUZUZUZUZUZUZUZUZUZUZUZUZUZUZUZUZUZ
pipipipipipipipiPhPhtGPhpipipipipipipipipipipioXoXoXpipipipipipiPhPhPhPhPhPhPhPhPhPhPhUZUZUZUZUZUZUZUZUZUZUZUZUZUZUZUZUZUZUZUZPh
pipipipipipipipiPhPhPhPhpipipipipipipipipipioXoXpipipipipipipipipipipipipipipipipiPhPhPhPhUZUZUZUZYGUZUZUZUZUZUZUZUZUZUZUZUZPhPh
pipipipipiPxpipipipipipipipipipipipipipioXoXoXoXoXoXpipipipipipipipipipipipipipipipipiPhPhPhPhUZUZUZUZUZUZUZUZUZUZUZUZUZUZPhPhpi
pipipipipipipipipipipipipipipipipipipipipipipipioXoXpipipipipipipipipipipipipipipipipipipiPhPhPhPhUZUZUZUZUZUZUZUZPhPhPhPhPhpipi
pipipipipipipipipipipipipipipipipipipioXpipipipipioXpipipipipipipipipipipipipipipipipipipipipiPhPhPhPhPhUZUZUZPhPhPhPhPhpipipipi
pipipipipipipipipipipioXoXpipipipioXoXoXoXoXoXoXpioXoXpipipipioXoXoXoXpipipipipipipipipipipipipipipipiPhPhUZPhPhpipipipipipipipi
pipipipipipipipipipipioXoXoXoXpipipioXpipipioXoXpipioXoXpipioXoXoXoXoXoXpipipipipipipipipipipipipipipipipioXpipipipipipipipipipi
pipipipipipipipipipipioXoXoXoXoXoXoXoXpipipipioXpipioXoXoXoXoXoXoXoXoXoXpipipipipipipipipipipipipipipioXoXoXoXpipipipipipipipipi
pipipipipipipipipipipipioXoXoXoXoXpipipipipioXoXoXoXoXpipipipioXoXoXoXoXpipipipipipipipipipipipipipioXoXpipioXpipipipipipipipipi
pipipipipipipipipipipipipioXoXpipipipipipipipipipipipipipipipipipioXoXpipipipipipipipipipipipipipipipipipipipipipipipipipipipipi
pipipipipipipipipipipipipipipipipipipipipipipipipipipipipipipipipipipipipipipipipipipipipipipipipipipipipipipipipipipipipipipipi
"}
